"filename", "language", "Python", "JSON", "pip requirements", "comment", "blank", "total"
"/Users/marvinottersberg/Documents/GitHub/sentiment/__init__.py", "Python", 0, 0, 0, 0, 1, 1
"/Users/marvinottersberg/Documents/GitHub/sentiment/config.py", "Python", 54, 0, 0, 18, 10, 82
"/Users/marvinottersberg/Documents/GitHub/sentiment/history/sentiment.py", "Python", 25, 0, 0, 3, 4, 32
"/Users/marvinottersberg/Documents/GitHub/sentiment/history/tweet_visualisation.py", "Python", 76, 0, 0, 13, 11, 100
"/Users/marvinottersberg/Documents/GitHub/sentiment/history/tweets.py", "Python", 62, 0, 0, 101, 24, 187
"/Users/marvinottersberg/Documents/GitHub/sentiment/main.py", "Python", 0, 0, 0, 2, 2, 4
"/Users/marvinottersberg/Documents/GitHub/sentiment/requirements.txt", "pip requirements", 0, 0, 19, 0, 0, 19
"/Users/marvinottersberg/Documents/GitHub/sentiment/sentiment/Json/12-07-2022/btc.json", "JSON", 0, 62955, 0, 0, 0, 62955
"/Users/marvinottersberg/Documents/GitHub/sentiment/sentiment/__init__.py", "Python", 0, 0, 0, 0, 1, 1
"/Users/marvinottersberg/Documents/GitHub/sentiment/sentiment/config/database.py", "Python", 0, 0, 0, 29, 6, 35
"/Users/marvinottersberg/Documents/GitHub/sentiment/sentiment/config/tweet_data_db.py", "Python", 0, 0, 0, 30, 7, 37
"/Users/marvinottersberg/Documents/GitHub/sentiment/sentiment/exporter.py", "Python", 47, 0, 0, 35, 19, 101
"/Users/marvinottersberg/Documents/GitHub/sentiment/sentiment/filter.py", "Python", 23, 0, 0, 16, 6, 45
"/Users/marvinottersberg/Documents/GitHub/sentiment/sentiment/listener.py", "Python", 105, 0, 0, 81, 35, 221
"/Users/marvinottersberg/Documents/GitHub/sentiment/sentiment/runner.py", "Python", 70, 0, 0, 21, 10, 101
"/Users/marvinottersberg/Documents/GitHub/sentiment/streamlit/01_ðŸ’¬_Tweets.py", "Python", 35, 0, 0, 31, 13, 79
"/Users/marvinottersberg/Documents/GitHub/sentiment/streamlit/local_streamlit_UI.py", "Python", 69, 0, 0, 15, 15, 99
"/Users/marvinottersberg/Documents/GitHub/sentiment/streamlit/pages/02_ðŸ“œ_Documentation.py", "Python", 0, 0, 0, 0, 1, 1
"/Users/marvinottersberg/Documents/GitHub/sentiment/streamlit/pages/03_ðŸ“€_Datasets.py", "Python", 15, 0, 0, 1, 1, 17
"/Users/marvinottersberg/Documents/GitHub/sentiment/streamlit/streamlit_data.py", "Python", 98, 0, 0, 17, 11, 126
"/Users/marvinottersberg/Documents/GitHub/sentiment/streamlit/visualise.py", "Python", 68, 0, 0, 13, 15, 96
"/Users/marvinottersberg/Documents/GitHub/sentiment/trading/test_visualisation.ipynb", "JSON", 0, 344, 0, 0, 1, 345
"Total", "-", 747, 63299, 19, 426, 193, 64684